8888888888888
8.R.......!.8
8.........R.8
8!..........8
8..!!.!..@..8
8.!.8R..8...8
8.8.8.8.!!..8
8..!....8.!!8
8.....!!88R.8
8....!...R..8
8.!.....X.!!8
8........R..8
8888888888888
ENDGRID
noscroll
scale 0.7
