8888888888888
8...8!@.!...8
88..R8!!...88
8R.!88R..8..8
8........!..8
8R..8.....!!8
8...!...8...8
8R.!........8
8..8!....!!.8
88!....8..!.8
8!..R.......8
8.!!....!X..8
8888888888888
ENDGRID
noscroll
scale 0.7
